1111111111111111111111111111111111111111111111111111111111111111111111111111111111111111111111111111
1P0000000000C00000000000000000000000000000000000C000000000000000000000000000000000000000000000000001
1000000000000000000000000000000000000000000000000000000000000000000000000000000000000000000000000001
10000000000000000000000000C00000000000000000000000C0000000000000000000000000000000000000000000000001
100000000000C000000000000000000000C0000000000000C000000000000000000000C000000000000000000C0000000001
10000000000000000000000000000000000000000000000000000000000000000000000000000000000000000000000000C1
1000000000000000000000000000000000000000000C00C00000000000000000000000000000000000000000000000000001
1000000000000000000000000000000000000000000000000000000000000000000000000000000000000000000000000001
100000000000000000000000000000000000000000000000000000000000000000000000000000000000000000000000C001
1000000000000000000000000000000000000000000000000000000C00000000000000000000C00000000000C00000000001
1000000000000000000000000000000000000000000000000000000000000000000000000000000000000000000000000001
10000C000000000000000000000000000000C00000000C0000000000000000000000000000000000C0000000000000000001
1000000000000000000000000000000000000000000000000000000C00000000000000000000000000000000000000000001
1000000000000000000000000000000000000000000000000000000000000000000000000000000000000000000000000001
1000000000000000000000000000000000000000000000000000000000000000000000000000000000000000000000000001
1000000000000000000000000000000000000000000000000000000000000000000000000000000000000000000000000001
1000000000C000000000000C000000000000000000000000000000000000000000C000000000000000000000000000000001
1000000000000000000000000000000000000000000000000000000000000000000000000000C000000000000000000000C1
1000000000000000000000000000000000000000000000000000000000000000000000000000000000000C00000000000001
1000000000000000000000000000000000000000000000000000000000000000000000000000000000000000000000000001
10000C0C00000000000C00000000000000000000000000000000000000000000000000000000000000000000000000000001
1000000000000000000000000000000000000000000000000000000000000000000000000000000000000000000000000001
100000000000000000000000000000000C000000000000000000000000000000000000000000000000000000000000000001
1000000000000000000000000000000000000000000000000000000000000000000000000000000000000000000000000001
1000000000000000000000000000000000000000000000000000000000000000000000000000000000000000000000000001
100000000000000000000000000000000000000000000C00000000000000000000C000000000000000000000C00000000001
100000000000000000000000000000000000000000000000C000000000000000000000000000000000000000000000000001
10000000000000000C0000000000000000000C00000000000000000000000000000C00000000000000000000000000C00001
1000000000000000000000000000000000000000000000000000000000000000000000000000000000000000000000000001
1000000000000000000000000000000000C00000000000000000000C00000000000000000000000000000000000000000001
10000000000000000000000000000C0C00000000000000000000000000000000000000000000000000000000000000C00001
100000000000000000000000000000000000000000000CC0000000000C000000000000000000000000000000000000000001
100000000C00000000000C00000C00000000000000000C000000000000000000000000000000000000000000000000000001
1000000000000000000000C00000000000000000000000000000000000000000000000000000000000000000000000000001
100000000000000000000000000000000000000000000000000000C00000000000000000000000C000000000000000000001
10000C000000000000000000000000C000000000000000000000000000000000000000000000000000000000000000000001
100000000C000000000000000000000000000000000000000000000000000000000000000000000000000000000000000001
1000000000000C0000000000000000C000000000000000000000000000000000000000000000000000000000000000000001
1C00000000000000000000000000000000000000C00000000000000000000000000000000000000000000000000000000001
1000000000000000000000000000000000000000000000000000000000000000C00000000000000000000000000000000001
10000000000000000000000000000000000C0000000000C00000000000000000000000000000000000000000000000000001
100000000000000000000000000000000000C000000000000000000000000000000000000000000000000000000000000001
100000000000000000000000000000C000000000000000C00000000000000000000000000000000000000000000000000001
100000000000000000C000000000000000000000000000000000000000000C00000000000000000000000000000000000001
100000000000000000000000000000000000000000000000000000000000000000000C0C0000000000000000000000000001
1000000000000000000000000000000000000000000000000000000000000000000000000000000000000000000000000001
1000000000000000000000000000000000000000000000000000000000000000000000000000000000000000000000000001
100000000000000000000000000000000000000000000000000000000CC00000C00000000000000000000000000000000001
1000000000000000000000000000000000000000000000000000000000000000000000000000000C000000000000000000E1
1111111111111111111111111111111111111111111111111111111111111111111111111111111111111111111111111111
