1111111111
1P00000001
1000C00P01
1000000E01
1111111111